S00007....
.....1....
.....1....
.....1....
.....1....
.....1....
.....1....
.....1....
.....8007.
........F.